#######################################
#$         #      #          #       $#
# #######    #### # ########   ###### #
#         #                  ##       #
# #### #### ###### ## ###### ## ### ###
#      #      @    ##               ###
#### # # #### ### ####### ##### ## ####
#    #    ###     #     #  #     #    #
# ## #  # #### ## # #      ## #   ### #
#$      #      #    #  ###    ###    $#
#######################################
