#######################################
#  #          ##       ##          #  #
#    ###### # #  # # #  # # ######    #
#   ##      # #    #    # #      ##   #
###    # #### # ## # ## # #### #    ###
#    # #       $   #   $       # #    #
#    # ## # ###$ #   # $### # ## #    #
# ####    #   ## ##### ##   #    #### #
# #     #   #    # @ #    #   #     # #
#    #   ######    #    ######   #    #
#######################################
