#######################################
#   #   #      #   @   #      #   #   #
# # #      ### # ##### # ###      # # #
# #    ###       #$ $#       ###    # #
#      #   #       #       #   #      #
### #### ### ############# ### #### ###
#      #   #       #       #   #      #
# #    ###       #$ $#       ###    # #
# # #      ### # ##### # ###      # # #
#   #   #      #       #      #   #   #
#######################################
